||--|-----||
|__ |____ ||
|||_ ||||_ |
|_ | | _ | |
|| |___|__ |
| _ ||| || |
| |___ _| _|
| ||||_| _||
| ___ || |||
| |||_ __ ||
|    | ||  |
|____|_|-__|
