|-|--|---|-|
| _| ___ | |
| |__||| _ |
|_ || ___| |
||____||| _|
| |||| _| ||
| ____ | _||
| |||| | | |
| | _| |_ _|
| _ ||_ | ||
| |   |    |
|_|___|____|
