|-|--|--|--|
| |_ || |_ |
|_ |_ __ | |
|| _| || | |
| _| _||__ |
| | _| _|| |
|___| _| | |
||||_ || | |
| __| _ _| |
| || _| || |
|    |     |
|____|_____|
