||-|-|--|--|
|_ _ __ |_ |
||_|_|| _| |
| | | __| _|
| __| ||_ ||
| ||| | | _|
| | __| __||
| __||_ || |
| ||| |___ |
| | __ ||| |
|   ||     |
|___|-_____|
