||-|--|-|-||
|_ |_ | | _|
||_ | __ _||
| | | || | |
| | |__|__ |
| | ||| || |
| |_____ | |
| _||||| | |
| | __ |_ _|
| | || || ||
|    |     |
|____|_____|
