|-|-|---|--|
| | __| |_ |
| | || _ | |
| | | _| | |
| | __|| _ |
| | |||_ | |
| | __ |_| |
| | ||_ | _|
| |__|| | ||
| ||| __| ||
|     ||   |
|_____|-___|
