||-|--|-|-||
|_ |_ | | _|
||_ | __ _||
| | | || |||
| | |_ |_ ||
| | ||__|_ |
| |_ ||||| |
| _|___ | _|
| | ||| _ ||
| | _ | |_ |
|   |    | |
|___|____|_|
