|-|-------||
| |______ _|
|_ |||||| ||
||_______ ||
||||||||| _|
|| __ _ | ||
|_ ||_| | _|
|| | |_ | ||
| _|_ | |_ |
| | | | || |
|     |    |
|_____|____|
