||-|-|-|--||
|_ | _ || _|
|| | |___ ||
| _|_ |||_ |
| | | |_ | |
| | _ ||_ _|
| | |__ | ||
| |_ || | ||
|_ |__| | _|
||_ ||| | ||
|||     |  |
||-_____|__|
