||-|-|-|---|
|_ _ | |__ |
||_|_ _ || |
| | |_| |_ |
|_ _ |_ _| |
|| |_ | | _|
| _|| |__ ||
| | | _||_ |
| |___| || |
|_ ||| _ | |
||     |   |
||_____|___|
