||-|-|-|-|-|
|_ | | _ _ |
|| |___| | |
| _|||| _| |
| | _ | |_ |
|___|____| |
|||| |||| _|
| ___| ___||
| ||| _||| |
| | _ || _ |
|   |    | |
|___|____|_|
