||-|-|-----|
|_ | _____ |
|| | ||||| |
| _|__ _ | |
| | || | |_|
| |_ __|_ ||
|_ |_|| | _|
|| || ___ ||
||__ _||| _|
| || |_ | ||
|     |    |
|_____|____|
