|-|-|-|-|-||
| | _ | _ ||
| | | | |_ |
|___| |__| |
|||| _||| _|
| _| |_ _ ||
| |_ _| |_ |
| _| | _|| |
| |____| _ |
|_ |||| _| |
||      |  |
||______|__|
