|-|--|-|---|
| |_ _ ||_ |
| || |__ | |
|____||| | |
||||| _|__ |
| __ _| || |
| || | _ | |
| |__| |___|
|_ || _ ||||
|| _ _| | _|
|  | |    ||
|__|_|____||
