|-|--|-|-|-|
| |_ | _ | |
| || __|__ |
|_ | || || |
|| | | __| |
|| | | ||| |
| _| | | __|
| |_ | | |||
|_ | | | | |
|| | | | | |
|    |     |
|____|_____|
