|-|-|-|--|-|
| | | _| _ |
| |__ || | |
| |||_ __| |
|_ _ |_||| |
||_|_ | _ _|
| | |_ _| ||
| __ |_||_ |
| ||_ |_ | |
| _ |_ | _ |
| |  |   | |
|_|__|___|_|
