||--|--|--||
|__ |_ __ ||
||| || ||__|
| |_ |__ |||
| _|_ || _ |
| | |_ |_| |
| ___| ||| |
| ||||__ _ |
| | _ ||_| |
| | |_ || _|
|    |    ||
|____|____||
