|-|--|---|-|
| || ___ |||
|____|||_ ||
||||| _ | _|
| _ _ |_| ||
| |_|_ || _|
|_ | | |_ ||
||_ _|_ |_ |
||| | |_ | |
|| _ _ | | |
|  | | |   |
|__|_|_|___|
