||-|-|-|-|-|
|_ | _ _ | |
|| | |_| _ |
| _| || _| |
| ||_ | |_ |
| | | | ||_|
| |___| _ ||
| |||||_| ||
|_____ ||_ |
|||||| _ | |
|      |   |
|______|___|
