||-|-|---|-|
|_ | ___ | |
||___||| | |
|||||_ | | |
|| _ | | | |
| _| | |__ |
| |__ __|| |
| |||_||| _|
| __ | _ _||
| ||_ _| | |
|   | |    |
|___|_|____|
