||-|----|-||
|_ |___ _ ||
|| _|||_|_ |
|| | _ ||| |
|_ | | ||| |
|| | |_ | _|
| _|_ |__ ||
| | | _||_ |
| __| | || |
| || _| _ _|
|    |  | ||
|____|__|_||
