||--|--|--||
|__ |_ |_ ||
||| _|_ |_ |
| __| |_ | |
| || _ |_ _|
| | _| || ||
|___||___ ||
||||_ |||_ |
|_ || _ _| |
||_ | | || |
|||   |    |
||-___|____|
