|-|-|--|-|-|
| | __ | _ |
| |_|| _ | |
|_ | __| |_|
||___|||_ ||
| ||| _ |_ |
| __ _|__| |
| ||_| ||| |
| __| _ ___|
| || _| ||||
|    |     |
|____|_____|
