|-|-|--|---|
| | __ ___ |
| |_|| ||| |
| _| __| __|
| | _||_ |||
|___| _| | |
|||| _||__ |
|_ __|_ || |
|| || | | _|
|| _ _ _ _||
|  | | | |||
|__|_|_|_|-|
