|-|--|--|-||
| _| __ | _|
| | _|| | ||
|___| | |_ |
||||_ | _| |
|_ || | || |
|| _ _|___ |
| _| | ||| |
| |_ |__ __|
|_ |_ || |||
||  |      |
||__|______|
