|-|---|-|--|
| ||_ _ |_ |
|__ | |_ | |
||| |_ |__ |
| |_ |_ || |
| || || ||_|
|_ |_ |__ ||
|| _| _|| _|
| _|_ | _ ||
| | | | |_ |
|        | |
|________|_|
