|-|--|-|-|-|
| |_ _ | _ |
|_ |_| __| |
||_ | _|| _|
| |___| __||
|_ ||| _|| |
|| | | |_ _|
| _ _| _| ||
| | || ||_ |
| |_ _ _ | |
|  | | |   |
|__|_|_|___|
