||--|-|--|-|
|__ | _| _ |
|||__ | _| |
| _|| | | _|
| | __| | ||
| __|| _| ||
| ||_ _|| _|
|_ || | __||
||____| || |
| |||| _ | |
|      |   |
|______|___|
