||-|---|-|-|
|_ ||_ _ | |
||__ |_| _ |
||||_ |__| |
|| _|_ || _|
| _|||_ | ||
| | | |__ _|
| _ _ ||| ||
| |_|_ _|_ |
| || | | | |
|    |     |
|____|_____|
