||-|--|-|--|
|_ |_ _ ||||
||_ | |_ |||
| | |_ |_ ||
| |_ |_ |__|
|_ | || ||||
|| |_ |___ |
|_ ||_ ||| |
||_ ||____ |
|||_ ||||| |
||||       |
||--_______|
