|-|--|----||
| _| ____ ||
| | _||||_ |
|_ _|_ _ | |
||_| | | | |
| | _ _| | |
| | | |__| |
| | |_ ||| |
| |_ |_____|
| || |||||||
|          |
|__________|
