||-|----|-||
|_ ____ | _|
||_||||__ ||
| | __ ||_ |
| | || | | |
| |_ |_ _| |
| || || | _|
| _ _ |_ _||
| |_|_ |_| |
| || |_ || |
|     |    |
|_____|____|
