||-|--|--|-|
|_ __ |_ _ |
||_||_ | | |
| |_ | |_| |
|_ | |_ |_ |
||_ _ | || |
| | | |___ |
| _ |_ ||| |
| |__|_| _ |
|_ || | _| |
||      |  |
||______|__|
