|-|--|-|--||
| |_ _ |_ ||
| _| |_ |_ |
| | __| _| |
| | || _|_ |
|___|_ | | |
|||| |__ | |
| __ |||__ |
| ||___ || |
| | ||| || |
|     |    |
|_____|____|
