|-|--|-|--||
| _| _ || _|
| |_ |__ _||
|_ |_ || |||
|| ||__|_ ||
||_ _|| |_ |
| | | __ | |
| | | || | |
| |___|__ _|
|_ ||| || ||
||         |
||_________|
