|-|---|-|-||
| ||_ | _ ||
|__ |__ |_ |
|||_ ||_ | |
|_ | __| |_|
|| __|| _ ||
|_ ||___|_ |
|| ||||||| |
| __| _ |_ |
| || _|_ | |
|    |||   |
|____|--___|
