|-|--|---|-|
| || |__ | |
|__ _ || __|
||| | |_ |||
| |_| _| _ |
|_ | _|__| |
|| __||||| |
|| || | __ |
| _| ___|| |
| | _|||| _|
|   |     ||
|___|_____||
