||-|-|-|-|-|
|_ | _ | | |
|| | |___ _|
| _|_ ||| ||
| | | __| _|
|__ |_|| _||
|||_ | _ |||
|_ | | |_ ||
|| _ |_ |_ |
| _| || _| |
| |     |  |
|_|_____|__|
