|-|--|-|---|
| |_ | ___ |
|_ |___||| |
|| |||| __ |
||__ _ _|| |
| ||_|_| __|
| _ | | _|||
| |_ _| |_ |
|_ | ||_ | |
|| |__ | | |
|   ||     |
|___|-_____|
