|-|-|-|-|-||
| _ | _ _ ||
|_| |_| |_ |
|| _|  _ | |
| _| __|_| |
| | _|  | _|
| |_|_ __ ||
| |    |  ||
|__ | _|__ |
||  | | |  |
|     |    |
|_____|____|
