||-|||-|-|-|
|_ |__ _ | |
|| |   |_ ||
||__ __| _ |
| | _| _ | |
| _ |_ | __|
| |_ | | | |
| |  __| | |
|_ |_|  _ _|
||_ | _ | ||
||    |    |
||____|____|
