|-|---|-||-|
| |   _ __ |
|_ |_ | |  |
||_ |_| | _|
| |_ | _| ||
| _|___| _ |
| | |   _| |
| ___ | |  |
| |  ___| _|
| __ |   _||
| |      | |
|_|______|_|
