||-||-||-|-|
|_ |_ __ _ |
||_ |_|  | |
| |_ |_ _| |
| _| |  |  |
| |_ _| | _|
| _| | _| ||
| |_ __| _ |
|_ |_|   |_|
||_ | _ _ ||
||    | |  |
||____|_|__|
