|-|-||-||-||
| | __ |_ _|
|___|  _| ||
||     | __|
| _ | _| | |
|_| __| __ |
|| _|  _|  |
| _| | |__ |
| |____|   |
|_ |    __ |
||      |  |
||______|__|
