|-|-|-|-|-||
| _ | _ | _|
|_| | |__ ||
|| _|_ | __|
| _|   _ | |
| |   _|__ |
|_ |__| |  |
||_ |  _ _ |
| |___ | | |
| |    | | |
|        | |
|________|_|
