||-|||-|-|-|
|_ |__ | | |
|| |  _ __ |
| __ |  | _|
|_|  _| _ ||
|| __| _| _|
| _|  _|  ||
| |___| _ ||
|_ |   _|_ |
|| | __| | |
|    |     |
|____|_____|
