|||||-|-|--|
|____ | |  |
||    |_ | |
| __ _| _ ||
| | _| | _ |
|__ |_ _ | |
||  | _| _ |
| |__ |__| |
| _|  |   _|
| |  __ | ||
|    |     |
|____|_____|
