|-|-|||-||-|
| _ |__ __ |
| |_ |  |  |
| _| _| |__|
|_| _| _|  |
|| _| _| _ |
| _| _| _| |
| |_ | _|_ |
|_ |___| | |
|| |    __ |
|       |  |
|_______|__|
