||-|||-|-|-|
|_ |__ _ | |
||_ |  | | |
| | |_ |__ |
| |_ | _|  |
|_ |___| | |
|| _|   _| |
|_ | _ _|_ |
|| _ |_| | |
| _| |  _ _|
| |     | ||
|_|_____|_||
