||-||-|-||-|
|_ |_ | |_ |
|| _|_ _ | |
|| | | |__ |
| _|_ _ |  |
| | | | |__|
| |__ |_ | |
| |  __| _ |
|_ _ |  _| |
|| |_ _ |  |
|   | |    |
|___|_|____|
