||-|||-||-||
|_ |__ __ _|
||_ | _|  ||
| |__ | |_ |
| _| ___ | |
| |_ |  __ |
|_ |_ _ |  |
||_ | |_| _|
||  __ |  ||
|| _|  | _ |
|  |     | |
|__|_____|_|
