||-|-|-|--||
|_ | _ |  _|
||___|___ ||
| |   |  _ |
| __| | |  |
| |  ______|
| ___|     |
| |   ___ _|
| |___|   ||
|_ |   __ ||
||     |   |
||_____|___|
