|-||-|-|-|-|
| |_ _ _ _ |
|_ |_| | | |
||_ | _| |_|
| | |_| _ ||
| |_ |_ | ||
| | _ |_|_ |
| _ | _| | |
| |___| __ |
| |    _|  |
|      |   |
|______|___|
