|||-|||-||-|
|__ |__ |_ |
|| _ | _ | |
| | __ |__ |
| _ | _ |  |
| |_ | _ | |
| _|__ |__ |
| | | _ |  |
| |_ _|____|
|_ | | |   |
||         |
||_________|
