|||-|-||||-|
|__ | ____ |
|| ___|    |
| _|   _ | |
| | __ |_| |
|_ _|  _| _|
|| |_ _| _||
| _ |_| _| |
| | | _ |  |
| |__ | | _|
|  |      ||
|__|______||
