||-|-||-||-|
|_ | __ __ |
||__ | _|  |
| | __ |__ |
| _ | _ |  |
| | _ |___ |
| | |_ |   |
| |__|_ _| |
| _|  |_|  |
| | _ |  _ |
|   |    | |
|___|____|_|
