|-|-|-|-||-|
| | _ _ __ |
|__ |_| |  |
|| _ |__ | |
|_ |_ | _| |
||_ | | | _|
||  |____ ||
|| _|     ||
| _| _ _| _|
| |  | |  ||
|    |     |
|____|_____|
