|-|--||-|-||
| |  |_ _ ||
|____ | |_ |
||    |_ |_|
| _ | _| | |
| |_| | __ |
|_ | __ |  |
|| _ | __ _|
|_ | |    ||
|| |_ | __ |
|   |   |  |
|___|___|__|
