|||-|-|-|-||
|__ | _ _ _|
||  _ |_| ||
| |_|_ | _ |
|_ | |___| |
|| _ _|   _|
|| | | _ _||
| _|_| |_| |
| |   _ |_ |
|_ | _| |  |
||   |     |
||___|_____|
