|-|-|-|-|-||
| _ | _ | _|
| | | |__ ||
|_| | _|  ||
|| _| | |_ |
| _|_____| |
| | |    _ |
|_ _____ | |
||_|     | |
| | __ | | |
|   |      |
|___|______|
