||||-|-|-|-|
|___ | _ _ |
||   | | |_|
| _ _| |_ ||
|_| | _ |_ |
|| _|_|_|  |
| _| |   _ |
| | _ |_ |_|
| | |_ |_ ||
| | _|_ | _|
|   |     ||
|___|_____||
