|-|-|-|-||-|
| | _ | __ |
| __| |_|  |
|_|   _| | |
|| ___| __ |
|_ |   _|  |
||___ _|__ |
| |  _| |  |
|_ _ | ____|
|| | | |   |
|  |       |
|__|_______|
