||-|-|-|-|-|
|_ _ | _ | |
||_|___| _ |
| |     _|_|
|_ | _| | ||
||_ _| _|_ |
| | | _| | |
| | __|_ | |
| __|    _ |
| |   | _| |
|       |  |
|_______|__|
