|-||-||-|-||
| __ |_ _ ||
|_| _ |_|_ |
|| _| _| | |
| _| _| __ |
| | _|_ |  |
| __| | | _|
| |  _ _| ||
|_ |_| |  ||
|| |  _| _ |
|     |  | |
|_____|__|_|
