||-|--|-|-||
|_ |  | _ ||
||____ _|_ |
| |   _|   |
|_ _ |  | _|
|| |_ __| ||
| _ |_|  _||
|_| _| __| |
|| _| _|  _|
|_ |  | _ ||
||      |  |
||______|__|
