|-||||-|-|-|
| ____ _ | |
|_|   _| | |
|| __|  _| |
| _|  __| _|
| | __| _ ||
| | |  _|_ |
| | |_ | | |
| | _|__ | |
| _ | |  _ |
| |      | |
|_|______|_|
