||-|-|-||-||
|_ | | __ _|
|| | _ |  ||
|| |_| |_ ||
| _|  _ |_ |
| |_ _| _| |
|_ |_| _| _|
||_ |__|  ||
|| _ |  _ ||
||  _ _ |_ |
||    |  | |
||____|__|_|
