||-||-||-|-|
|_ |_ __ | |
|| |  | __ |
| __| | |  |
| |  _|_ | |
|____| | __|
||   _ | | |
|_ _ | | | |
|| |_ _|__ |
| _ | | |  |
| | |      |
|_|_|______|
