|||-||-||-||
|__ |_ __ _|
|| _ |_|  ||
| _| | __ _|
| | __ |  ||
| _ |  |_ _|
| |_ | |  ||
|_ | |__ _ |
|| |_ | _| |
| _ | | | _|
| | |     ||
|_|_|_____||
