||-||-|-||||
|_ |_ | ___|
|| _| _ |  |
|| | _|___ |
| _| | |   |
| |_ | _ | |
|_ |___| | |
||_ |   _| |
| |____ | _|
| |     _ ||
|       |  |
|_______|__|
