|||-|--|||-|
|__ |  |__ |
|| ____ |  |
| _|   ___ |
| | __ |   |
| | | __ | |
| __| | ___|
| |   _ |  |
| |_ _| |_ |
|_ | | _ | |
||   | |   |
||___|_|___|
