||-||-|-|-||
|_ __ _ | _|
||_| _|__ ||
| | |  |  ||
| ___ _|  _|
|_|   | __||
||  __| |  |
| _ |   | _|
| |_| __| ||
| |   |  _ |
|        | |
|________|_|
