||-|-|||||-|
|_ | _____ |
|| |_|     |
| _|  ____ |
| | __|    |
|_ _|  _ __|
||_| __|_| |
| | _|  | _|
| __| | _ ||
| |  _ _| ||
|    | |   |
|____|_|___|
