|-|-||-|||-|
| | |_ ___ |
|___ | |  _|
||   |_ _ ||
|_ |_ |_|_ |
||_ |_ |   |
| | _|_ |_ |
| _ | | |  |
| |__ |___ |
|_ | _ |   |
||   |     |
||___|_____|
