|-|-|--|-|-|
| | |  _ _ |
| |_ _ | | |
|_ |_| |_| |
||_ |__ | _|
| |_ |  | ||
| |  | _|_ |
|_ | | | | |
|| __|___| |
|| |  |   _|
|         ||
|_________||
