|-|-|-|-|-||
| | | | _ ||
| |__ _ |_ |
|_ |  |__| |
|| | _|   _|
| _|_| __ ||
| | | _|  ||
| |_ _|_ _ |
| _| | |_| |
| |  |_ |  |
|     |    |
|_____|____|
