||||-|---|-|
|___ |   _ |
||   _| _| |
|_ | | _| _|
|| | |_|  ||
| _| _| __ |
| | _| _|  |
| | |  | | |
| |__ _| | |
|_ |  |_ | |
||     |   |
||_____|___|
