|-||||-|-|-|
| |___ | _ |
|_ |  _ _| |
||__ |  | _|
| |  _| | ||
| ___| _|_ |
| |   _| | |
| |__ |_ _ |
| |  _ |_| |
| _ |  _| _|
| |    |  ||
|_|____|__||
