|-|----|-|-|
| |    _ | |
|_ | __|__ |
||__ |     |
||  __ | _ |
|| _|  | | |
| _| __| |_|
| | _| __ ||
| | |     _|
| __ |  _ ||
| |     |  |
|_|_____|__|
