|-||-|-|-|-|
| |_ | | | |
| |  ____ _|
|_ |_|    ||
||_ | __ _ |
|| _ _|  | |
|| |_| |_| |
| __| _ | _|
| |  _| | ||
| | _|  _ ||
|   |   |  |
|___|___|__|
